ChallengeMode_0=ChallengeMode_0
ChallengeMode_1=ChallengeMode_1
ChallengeMode_2=ChallengeMode_2
ChallengeMode_3=ChallengeMode_3
ChallengeMode_4=ChallengeMode_4
Chapter_0=Chapter_0
Chapter_0_Scene=Chapter_0_Scene
ConstructionMode_CraftsmanCamp=ConstructionMode_CraftsmanCamp
ConstructionMode_Stope=ConstructionMode_Stope
ConstructionMode_Tomb=ConstructionMode_Tomb
Ammo=Prefab/Ammo
Ammo_Bone=Prefab/Ammo_Bone
AreaUnlockDialogPanel=Prefab/AreaUnlockDialogPanel
AttributePanel=Prefab/AttributePanel
AuraFlagEntity=Prefab/AuraFlagEntity
AutoSlot=Prefab/AutoSlot
BattleCompletePanel=Prefab/BattleCompletePanel
BattleFalsePanel=Prefab/BattleFalsePanel
BattleFieldMark=Prefab/BattleFieldMark
BattleMiniMapControlFlag=Prefab/BattleMiniMapControlFlag
BattlePreparePanel=Prefab/BattlePreparePanel
BattleResultPanel=Prefab/BattleResultPanel
BuildingControl=Prefab/BuildingControl
BurstEffect=Prefab/BurstEffect
BurstEffectRed=Prefab/BurstEffectRed
BurstEffectWhite=Prefab/BurstEffectWhite
ChargeSpecialEffects=Prefab/ChargeSpecialEffects
ChooseNextPanel=Prefab/ChooseNextPanel
ControlFlag=Prefab/ControlFlag
ControlGeneralFlag=Prefab/ControlGeneralFlag
ControlGenralFlag=Prefab/ControlGenralFlag
DeadRaiseEffect=Prefab/DeadRaiseEffect
DecalProjector=Prefab/DecalProjector
Dialog=Prefab/Dialog
Dialog_Bubble=Prefab/Dialog_Bubble
Dialog_Panel=Prefab/Dialog_Panel
DialogBox=Prefab/DialogBox
DropDownFire=Prefab/DropDownFire
Dust=Prefab/Dust
EAUIPanel=Prefab/EAUIPanel
SpeedUpEffect=Prefab/Effect/SpeedUpEffect
EmotionBubble=Prefab/EmotionBubble
GameObject=Prefab/GameObject
Guide=Prefab/Guide
Image=Prefab/Image
IndicateUnitButton=Prefab/IndicateUnitButton
LegionControl=Prefab/LegionControl
LegionTroopSerial=Prefab/LegionTroopSerial
ImmovableObstacle=Prefab/MapObstacle/ImmovableObstacle
MapTerrain 1=Prefab/MapObstacle/MapTerrain 1
Model_A_HumanMelee=Prefab/Model_A_HumanMelee
Model_Basic=Prefab/Model_Basic
Model_Beast=Prefab/Model_Beast
Model_General=Prefab/Model_General
ModelPreview=Prefab/ModelPreview
MoveArrow=Prefab/MoveArrow
PausePanel=Prefab/PausePanel
QuestDetail=Prefab/QuestDetail
QuestUI=Prefab/QuestUI
RaiseCircle=Prefab/RaiseCircle
RaiseGetTroopPanel=Prefab/RaiseGetTroopPanel
RaiseUnitPanel=Prefab/RaiseUnitPanel
ResurrectionPanel=Prefab/ResurrectionPanel
RogueBehaviorBetton=Prefab/RogueBehaviorBetton
SimpleDialogPanel=Prefab/SimpleDialogPanel
SmallExplosionEffect=Prefab/SmallExplosionEffect
SpeciesPanel=Prefab/SpeciesPanel
StartChoosePanel=Prefab/StartChoosePanel
StoneHitEffect=Prefab/StoneHitEffect
TerrainDecal=Prefab/TerrainDecal
TipPanel=Prefab/TipPanel
Tree=Prefab/Tree
TutorialButton=Prefab/TutorialButton
UnitDetailPanel=Prefab/UnitDetailPanel
UnitOrganizationPanel=Prefab/UnitOrganizationPanel
UnitPanel=Prefab/UnitPanel
RogueMode_0=RogueMode_0
rueTerrain=rueTerrain
AttackSkill1=Skill/AttackSkill1
ChargeSkill=Skill/ChargeSkill
EarthsplitSlashSkill=Skill/EarthsplitSlashSkill
LeapSlashSkill=Skill/LeapSlashSkill
ShapelessShieldSkill=Skill/ShapelessShieldSkill
TestScene=TestScene
TutorialMap=TutorialMap
